##########################################################################################################################################################
#................>#...........##............#...........##................>#......................>#..........#.......................>#..................
#.....#...........>...........>#............>...........##.................>........%..............>...................................>.........#........
#..............................>........................^........................................................#.........#..............................
#...........^.......................................................#...........................#.........................................................
#........................................................:......................................>................................#........................
#.........................................................................................................................<...............................
#............................<...................#......^.................#.........%...............#.....................#.................#.............
#.@.................<........#.............#..............................>............<..................................................................
#...................#........#..........................##.............................#......................#..................#........................
##########################################################################################################################################################
