############################################################################################################################
#$..........................................................................................................................
#...........................................................................................................#...............
#...........................#......................................................#........................................
#...........#.........#...........................#...............#.........................................................
#.........................................#.........................................................;;;.....................
#..........................................................................................................#................
#.....................:..:..:..:.....................................................................#......................
#.....................'..'..'..'...........................................###..............................................
#.@.............................................................#.......................................;...................
############################################################################################################################
